03 03 11 10 10 12 03 03 03 03 03 05 03 05 03 03
03 03 11 10 10 12 03 03 05 03 03 03 03 03 03 03
03 03 11 10 10 12 05 03 03 03 03 03 05 05 03 03
03 03 11 10 10 12 03 03 03 05 03 03 03 03 03 03
03 03 11 10 10 20 13 13 13 13 13 13 13 13 13 13
03 03 11 10 10 10 10 10 10 10 10 10 10 10 10 10
03 03 18 14 14 14 14 14 14 14 14 14 14 14 14 14
08 08 03 03 07 03 03 03 03 03 03 03 06 07 03 03
03 08 03 03 03 03 09 03 03 08 06 03 03 03 09 08
03 03 03 09 03 03 03 03 03 03 07 04 04 04 04 04
06 03 03 03 03 03 03 09 03 07 03 04 04 04 04 04
03 03 03 03 03 06 03 03 03 03 03 04 04 04 04 04